zdraví - die Gesundheit
nemoc - die Kranheit 
lidské tělo - menschlicher Körper
lékař - der Arzt
u lékaře - beim Arzt
paže - der Arm
oko - das Auge
břicho - der Bauch
noha - das Bein
pálit - brennen
To pálilo. - Es hat gebrannt.
hrudník, prsa - die Brust
loket - der Ellbogen
lenoch - das Faultier
prst - der Finger
cítit se - sich fühlen
hrát na počítači - am Computer spielen
zadek - der Po
vlas - das Haar
krk - der Hals
koleno - das Knie
hlava - der Kopf 
tělo - der Körper
ústa - der Mund
nos - die Nase
Teče mi z nosu. (mám rýmu) - Meine Nase läuft.
ucho - das Ohr
záda - der Rücken
bolest - der Schmerz
Bolí mě v krku. - Ich habe Halsschmerzen.
rameno - die Schulter
bolet - weh tun
Bolela mě hlava. - Mein Kopf hat wehgetan.
prst na noze - der Zeh
vousy - der Bart
hustý - dicht
hubený - dünn
obličej - das Gesicht
hladký - glatt
pleš - die Glatze
brada - das Kinn
ret, rty - die Lippe
jizva - die Narbe
kulatý - rund
piha - die Sommersprosse
čelo - die Stirn
tvář - die Wange
řasa - die Wimper
zub - der Zahn
jazyk - die Zunge