řasa - die Wimper
čelo - die Stirn
ústa - der Mund
záda - der Rücken
zub - der Zahn
zdraví - die Gesundheit
zadek - der Po
vousy - der Bart
vlas - das Haar
ucho - das Ohr
u lékaře - beim Arzt
tělo - der Körper
tvář - die Wange
ret, rty - die Lippe
rameno - die Schulter
pálit - brennen
prst na noze - der Zeh
prst - der Finger
pleš - die Glatze
piha - die Sommersprosse
paže - der Arm
oko - das Auge
obličej - das Gesicht
nos - die Nase
noha - das Bein
nemoc - die Kranheit 
lékař - der Arzt
loket - der Ellbogen
lidské tělo - menschlicher Körper
lenoch - das Faultier
kulatý - rund
krk - der Hals
koleno - das Knie
jizva - die Narbe
jazyk - die Zunge
hustý - dicht
hubený - dünn
hrát na počítači - am Computer spielen
hrudník, prsa - die Brust
hlava - der Kopf 
hladký - glatt
cítit se - sich fühlen
břicho - der Bauch
brada - das Kinn
bolet - weh tun
bolest - der Schmerz
To pálilo. - Es hat gebrannt.
Teče mi z nosu. (mám rýmu) - Meine Nase läuft.
Bolí mě v krku. - Ich habe Halsschmerzen.
Bolela mě hlava. - Mein Kopf hat wehgetan.
